1111111111111111111111111111111111111111111111111111111111111111111111111111111
1S0****000000000000000000000E000000000000000000000000000000000000000000000000K1
1111011110111011110111110111011110111110111110111110111110111110111110111111011
1K00000000000000000000000000000000000000000000000000E000000000000000000000000@1
111111011111111Z11111$11111E11111011111011111$11111011111011111011111$111011111
1@00000000000000000000000000000000000000000000000000E000000000000000000000000K1
111111011111111011111011111$11111011111$11111011111$11111011111$111110111$11111
1K00000000000000000000000000000000000000000000000000E000000000000000000000000@1
111111011111111011111011111011111$11111011111011111011111$111110111110111011111
1@0000000000000000000000000E000000000000000000000000E000000000000000000000000@1
10000000000000000000000000000000000000000000000000000000000000000000000000000K1
1111011110111011110111110111011110111110111110111110111110111110111110111111011
1K00000000000000000000000000000000000000000000000000E000000000000000000000000@1
1111110111111110111110111110111110111110111110111110111110111110111110111111111
1000000000000000000000000000000000000000000000000000000000000000000000111111111
1@0000000000000000000000000E000000000000000000000000E000000000000000000000000D1
111111*11111111Z11111*11111*11111*11111*11111*11111*11111*11111*11111*111*111#1
1111111111111111111111111111111111111111111111111111111111111111111111111111111
